11111111111111111111111111111111111111
1P000000000000000000000000000000000001
10000000000000000000000000000000000001
10000000000000000000000000000000000001
10000000000000000000000000000000000001
10000000000000000000000C00000000000001
10000000000000000000000000000000000001
10000000000000C00000000000000000000001
10000000000000000000000000000000000001
10000000000000000000000000000000000001
10000000000000000000000000000000000001
10000000000000000000000000000000000001
10000000000000000000000000000000000001
10000000000000000000000000000000000001
10000000000000000000000000000000C00001
10000000000000000000000000000000000001
10000000000000000000000000000000000001
10000000000000000000000000C000000000E1
11111111111111111111111111111111111111
